   

     NO   ./textures/north_wall.xpm  

   R    800 600
   

  SO  ./textures/south_wall.xpm  
   EA    ./textures/east_wall.xpm  

  
   S     ./textures/sprite.xpm   
   C  150 ,  200,  243
 
  WE     ./textures/west_wall.xpm   


     F     46   ,   139    ,87
      


        
       
   
                      11    
                  1111001111 
  1              110000000001   1
  1111111111111111101001111111110111
  1000000000011000000000000000000001  
  101100000111000000000000000000001
 1001000000000000000000000000000011
 1111111110011000001110000000000001  
  10000000000110000011100000000111111
  1011110111111111011100000000010001
 111011111111101110101000002000011111
 110000000000000000000000000000000111
  1111111100000000000000111000111111
  1      1000000000000001 1000000011  
  1      1000000000000001 1000000001
  1       11000000000000011111000001
  1       1100000000000001000000001
  1       100000000102000100N0000001
  1111111100000000000000010000000001                    
   100000000000000000110000000000001   
  100000200000000011010100100100001
  100000111010101111101111000000000111
   111011101110101010111101000000000001  
      1000000000000000000000000000000001 
      10011000000000000011100000000000001  
   1110011111111100111110001111111111111
     111        101    10001 
                111     111     

                 
                  


   


           